11-11
00T0000T000
00T000T00T0
000T0000T00
00TT0000T00
00T00000000
00T00C00000
00D0000TT00
000000000C0
00T000TT000
00000T00000
0T000000T00