101-101
00000000011111000000000000000000000000000000100000000000000000000000000000000000000000000000000000002
00000000011110000000000000000000000000000011100000000000000000000000000000000000000000000000000002222
00000000011100000000000000000000000000000111100000000000000000000000000000000000000000000000000002222
00000000111111000000000000000000000000001111111100000000000000000000000000000000000000000000000002222
00000000011111100000000000000000000000000111111111000000000000000000000000000000000000000000000022233
00000000011111110000000000000000000000000111111111100000000000000000000000000000000000000000000003322
00000000011110111100000000000000000000000011111111110000000000000000000000000000000000000000003332222
00000000000111100110000000000000000000000011111101011000000000000000000000000000000000333333333002222
00000000000111001111000000000000000000000011110100001100000000000000000000000333333333000000000000002
00000000000111101111000000000000000000000001111100000000000000000000000000033000000000000000000000000
00000000000111001111100000000000000000000000110000000000000000000000000000300000010000000000000000000
00000000000011111111100000000000000000000000010000000000000000000000000003000000011100000000000000000
00000000000001000111000000000000000000000000000000000000000000000000000003000001111110000000000000000
00000000000000000111000000000000000000000000000000000000000000000100000030000001101111000000000000000
00000000000000000100000000000000000000000000000000000000000000011111000030000001111111100000000000000
00000000000000000000000000000000000000000000000000000000000000111111111030000000011111100000000000000
00000000000000000000000000000000000000000000000000000000000000111111111310000000001000000000000000000
00000000000000000000000000000000000000000000000000000000000000011111113111100000000000000000000000000
00000000000000000000000000000000000000000000000000000000000000011133311111111100000000000000000000000
00000000000000000000000000000000000000000000000000000000003333333311111111111000000000000000000000000
00000000000000000000000000000000000000033333333333333333330000011111111111111000000000000000000020000
00000000000000000000000000003333333333300000000000000000000000011111111111111110000000000001122222220
00000000000000000000333333330000000000000000000000000000000000011111111111111110000000000001122222220
00000000000033333333000000000000000000000000000000000000000000001111111111111110000000001111122222220
33333333333300000000000000000000000000000000000000000000000000000111111111111111000000000111222222222
00000000000000000000000000000000000000000000000000000000000020000111111111111111000000001111122222220
00000111110000000000000000000000000000000000000000000000022222220111111111111110000000001111122222220
00001111100000000000000000000000000000000000000000000000022222220111101111111111000000001111122222221
00001111100000000000000000000000000000000000000000000000022222220111111111111111000000011011111121111
00001111111000000000000000000000000000000000000000000000222222222011111111111111000000101111111111111
00001111111110000000000000000000000000000000000000000000022222220011111111111111000011111101011111111
00000011111101000000000000000000000000000000000000000000022222220011111101111111110111111110111111111
00000011101110000000000000000000000000000000000000000000022222220001111111111111111001111111111111111
00000011111011000000000000000000000000000000000000000000000020000000011111111111111011111110011101100
00000001011000000000000000000000000000000000000000000000000000000000011111111111110011111110000111100
00000000011000000000000000000000000000000000000000000000000000000000010111111111110011111111100111110
00000000000000000000000000000000000000000011100000000000000000000000000010101111111011111111100101100
00000000000000000000000000000000000000001111100000000000000000000000000000011111111111111111110110000
00000000000000000000000000000000000000011111100000000000000000000000000000001111111111111111111110000
00000000000000000000000000000000000000111111100000000000000000000000000000001111111111111111111111110
00000000000000000000000000000000000000011111000000000000000000000000000000011111111111211111111111110
00000000000000000000000000000000000000011111100000000000000000011000000000011111111222222211111111111
00000000000000000000000000000000000001111111000000000000000001111000000000001111111222222211111111111
00000000000000000000000000000000000000111110000000000000000001111100000000001111111222222211111111111
00000000000000000000000000000000000001111111000000000000000001111100000000001111112222222221111111111
00000000000000000000000000000000000000111111100000000000000011111111000000000111111222222211111111111
00000000000000000000000000000000000000111110100000000000000011111111000000000111111222222211111111111
00000000000000000000000000000000000000001111000000000000000011111111000000000111111222222211111111111
00000000000000000000000000011100000000010111100000000000000011111111110000000111111222222211111111111
00000000000000000000000001111110000000001110000000000000000001111111110000000011111222222211111111111
00000000000000000000000001111111000000011111000000000000000001111111110000000011112222222221111111111
00000000000000000000000111111000000000011111000000000000000001111111110000000001111222222211111111111
00000100000000000000000111111110000000011111110000000000000000011111110000000012111222222211111111111
00001111000000000000000011111111100000011111110000000000000000111111111000002222222222222211111111100
00011111100000000000000011111111100000011111110000000000000000111111111110002222222111211111111111110
00011111000000000000000011111111111000011111111000000000000000111111111110002222222111111111111111111
00111111000000000000000011101111111000001111111100000000000000111111111111122222222211111111111111110
00001011100000000000000001000101111110000111111100000000000000111111111111112222222111111111111111110
00000100110000000000000000000011111111000011111100000000000000111111111111102222222111001111111111111
33333333333333300000000000000011111111000111111110000000000001011111111111112222222110000111111111111
00000000000000033333333000000001111111111111111110000000000000111111111111111002000010000101111111111
00000000000000000000000333333301111111111111111111000000000000111111111111111100000000000001111111111
00000000000000000000000000000033333333311111111111000000000000011111111111111111100000000200113333333
00000000000000000000000000000000000000133333311111000000000000111111111111111111100000233333331111110
00000000000000000000000000000000000001111111133333100000000000113333333111111113333333322222200111111
00000000000000000000000000000000000000111111111100333333333333331111111333333331110000222222200011111
00000000000000000000000000000000000000011111111133110000000000111111111111111111110002222222220111111
00000000000000000000000000000000000000011111113311111100000000001111111111111111111000222222200011111
00000000000000000000000000000000000000001111331111111110000000011111111111111111111110222222200011111
00000000000000000000000000000000000000001113111111111110000000011111111111111111111111222222200011111
00110000000000000000000000000000000000011131111111111100000001111111111111111111111111000200000021111
11110000000000000000000000000000000000011311111111111000000011111111111111111111111001100000022222221
11110000000000000000000000000000000000013111111111111110000111111111111111111111110001000000022222221
11111000001100000000000000000000000000131101111111111110000111111111111111111111110000000000022222221
11111000001110000000000000000000000001311110111111111110000011111111111111111111111000000000222222222
11111110001110000000000000000000000003111111111111111110100001111111111111111111110100000000022222221
01111100001111000000000000000000000030111111121111111111100001011111111111111111111110000000022222220
00001000000110000000000000000000000300001122222221111111110000011111111111111111111110000000022222220
00000000000110000000000000000000033000001022222221111111110000010111111111111111111110000000000020000
00000000001100000000000000000000300000000022222221111111111000000111111111111111111100000000000000000
00000000001000000000000000000033000100000222222222111111111100001111111111111111111100000000000000000
00000000000000000000000000033300001111000022222221111111011000001111111111111111111110000000000000000
00000000000000000000000033300000001111100022222221111111001100000111111111111111111111000000000000000
00000000000000000003333300000000000111100022222221111110000000001111111111111111111111110000000000000
00000000333333333330000000000000000011110000021111111111000000001101111111111111111111110000000000000
33333333300000000000000000000001200001112111011111111111110000001101111111111111111111111100000000000
00000000000000000000000000000222222202222222101111111111100000001100111111111111111111111100000000000
00000000000000000000000000000222222202222222100101111111111100000000111111111111111111111000000000000
00000000000000000000000000001222222202222222100000111111111110000001111111111111111111111000000000000
00000000000000000000000000002222222222222222200000101111111100000000111111111111111111111100000000000
00000000000000000000000000001222222202222222100000001111111111000000111111111111111111111100000000000
00000000000000000000000000001222222212222222000000001111111111000000111111111111111111111110000000000
00000000000000000000000000000222222202222222100000000001111111000000101011111111111000111100000000000
00000000000000000000000000000000211000112111000000000011111111111000000001111110110000011000000000000
00000000000000000000000000000011101100111111000000000111111111111000000001111101100000001000000000000
00010000000000000000000000000001111111111111100000000111111111101110000000111111000000000000000000000
01110000000000000000000000000001111111111111110000001011111111111111000000011111000000000000000000000
01111000000000000000000000000000110111111111100000011111111111111111000000011111000000000000000000000
11111100000000000000000000000000111110111111100000111111111111111011000000111110000000000000000000000
11111100000000000000000000000000111111111111110000111111111111111111100000011111000000000000000000000
11111100000000000000000000000000101111111111111001111111111111111111000000111101000000000000000000000
