101-101
000002222222000000000000000000000T000T0000T000000000000002T222T2000000000000010000TT0000000T000000000
0000022222220T000000000000T000T0000000000000T0000T0T0000T22222220000000000001111T0000000T000000000000
00T00222222200000000000000000T00011110000000000T0T0000T02222222220000000000T11111T0000T00T00000000000
000022T222222000000000000000000011111T000000000T00000000T22222220000000000T111111000TTT00T000T0000000
000T02222222000000000000000000011111100000000000000000000T222222000000T201011111T0000T00000T00T2000T0
00000222222T00000000000000000001111T00000T0000000000000002T2222200002T222T21111110000000000022222220T
0000022222T20T00T000T0020000000111111000T00000000000000000002000000022222221111110000000000022T2222T0
00000000200000000000222222200T00111111000000000TT0T00000T0000000011122222221101110000000000022222T200
00000000000000000000222222200000100111100000000000000000000T0010011T22222222011T0000000T0002222222220
00000000T00T0000000022222220000000011000000000000000000000000111T1T12222222111100000000000T0222222200
00000000000T0000000222T2222200000001110000000T000000000000000011TT112222222T1T1T0T0T00000000222T22200
0000000TT000T000000022222220000000000000T0000000000000000000001111T1222T222111000000T000000022222220T
00000000000000TTT000222222200TT00000000T000T00000000000000T00011111100122222220T0000000000000002T0000
000000000000000000002T2T222000000000000000000000000000000000T0011110000T222T2TT000000000T000000000000
00000000000000000T0020020T000000000000000000T00000T0000000000000100000T2222222000000000000000T00TT00T
000000000000000002222T22T000000000000000000T00000000000000T000000000002222222T2000000000000000000T000
0000000000000000022222220T000000000010000000000T0000000000000000000000022222220000000000T000000000000
0000000000T0000T0T222222T000T000001111T000T00T000000000000000000T000000222222T00000000000000000000T0T
0000000000000TT02222222220000000000111000000000000T000T0000000000000002222222200000000000T00000000000
00000000000000T0022T22T200000T00000111000000000000000T000TT000000T0000222222200000000000T000T00000000
0000000000000000022222T20000000T0001100001T10000000000T000T000000000T02222222000000000000000000000000
0000000000000000022222220000000T000100TT1111000000T000T000000TT00000T22222T2220000000000000000T000000
0000000000000T0T0000200000T00000000T0001111110T0000T0T0000000000T0T000222222200000000T00000000000T000
00000000000T0000000000000000000T20000001111111T000000000T00T000000T0002222T22000000000000000000000000
0T000000000000T000000000000002222222000111111100000000TT00000T0000000022222220000T00000T0111111TT00T0
00000000000000T000T0000000000222222200011111110000000000000000T00000000T020TT100000000000T11111000000
00T0000T00T000000000000000000TT2222200T011T111100000000000000000000000000001111000T000001111111100000
0000000T0000000000000000000022222222201111111111100T0000000000000000000001111111100000000111111110000
T000000T00000000T00000000000022222220011111T111111000000000000000000000T00T111111100TTT001T1111111000
0T0T00T000000000000T00000T0002T222220T1T11111111T000000000T0000T0000000T011111111100000000011111T1000
00000000000000000000000T00000222222T00111111111111000000T0TTT000000000000111111110000000001111TT10000
0000000000000000T000000000000T002000T01111111T1111000T00T000000T0000000000111111100000000001111111000
000000000000000000000000000000000T000T01111111111110000T00T00000000000T000111T101100000000111T1111110
00T0000000000000000000T000T00022222220T11111T111111T000TT000000000000000000111111110T0000111111111100
0000000000000000T00000T0T000002222222010111111111110000000000000T0000000000000111110000T0111111111000
0000T00000000000000000000000002222222000111111111T11000T00000000TT000000000000011T0000000111111111000
0000000000000000000000000000T22222222T00011111T11111000000000000000000T00000000101000000001T11121T100
0000000000000000000000000T00002222222T000111111T1111000000000T0000000000000000001T0T00000T002TT2222T0
00000T0T000020000000000000000T22222220011111T11111111000000000000T00T00000000000110000222222222222200
000000000222222200000000T00000222T22200T111111111T1T00000000T1T00T00000000000000011000222222222222200
T00000000222222200000000000000000200T00011111T1111111000TT11T1110T0000000000000000T00022T222222222220
0T000T00T2222222000TT000000000T0000000T01111111T1111110T011111100000T0000T0000000000022222222TTT22200
0000000T2222222220000000000T000000T0000001111111111011100111111100000T0000000000000000222T22222222200
0000000T022222220000000000000T000000000001011111110101110111T11100000000000T0000000000222222222222200
00000000022222T200000000000000000000000000001100111T000001011T11000000000000T00000000T222222200200000
00000000022222220000000000T0000000000000000011000110T0000T1111110000000T00T00000000000000200000000000
00000000022222220000000000010T0001100000T00010000000T000011111101000000000000000000000000000000000000
0000000002222T220000T011111T11111111000000TT0000000000T00111111T100000T000T0000000T000000000000T00000
00000T002T222T22200001111T111111111TT100000000T00000000000111T1TT0000000000000000T00000000000000T0000
00T00000022T222T00000T22222221111111111T0T000000000000000011111110000T0000000000000000000000000000T00
00000TT002222T2220000T222222211111111100000000000000000000111012T100000000T0T0000000000000000T0000000
0000000002222222T22200T22T22211T11T1110000000000T000000T0T11222T222100000000T00000000000000000T000000
0T0000000000222T2222022222T22211111111100T00000000000000001122222221100000000000T0000T000200T0000T000
000000000T00022222220T222T22T1111T1111100T0000000T00T000010TT22222211110000000000000TT2222222000T0000
00000000000T2T222222202T222221111111100000000T0000000011T112222222221111T00T0000000000222222T000000T0
00000000000002222T2T002T22222111111T110000000T000000001T11112222222T111110000000000000T22222TTT000000
000000000000022222T200111211111111111T1T1T000000000T0001T11122222221T1111000T00000000T222T2T22T000000
00000000000112T22T22100111111111T1111111T111000000000011111122TT2222111110000000000000222T2T200000T00
00000T0000111111211110001T1111111111111111111100000001111111122222221111000000000T0T0022222220000TT00
0000000001111111111110000111T1111T11111111111111100000111111122222221111100000000002T2222T22200001100
000000000111111111111100011111111111111T111111110000001T011T2222222T21111T00000T000222222200000011111
T0T0000T011111111111T110011111111111110T1111111100000011101112222222111110100T00000222222200000T0TT11
00000000011111111111T100111111111111T11111111T111000000T111112222222T111110000000T22222222200T0000111
000000T0111111T111T11110011111111T1111111211111110T000000001022222T21111111110T0T00222222200200000011
000T2001111111111111T0101T1111T1111111222TT221T111T0000000T00T00T111111111110T0T00022222222222TT000T1
T222222211111T1111110000101111111111112222T221111110000000000000111111111111000000022222222T222TT0000
0222T22201111111111TT10000T111T11111112222222T1111100000000000001111111111T110000000002002222T2200000
022222T20011111T1111T1TT0011111111111222222222111110000000T0T0T11111111111100000T00000T02222222220000
22222222211111111T1111100111111111111122222221111111000000001110111111T1111000000T00000002222222T000T
02T22T220111111111T1T111100111111112112222222T1111110000000001111111111111T1000000000T00022T222200000
0222222T01111111T1111110101T1111T222222T222221111T1110000000T1T111111T1111111110000000000222T2220T000
02222222T11111110T111T11111111112222222112111111111110002002222222TTT111TT1111110000T0T000002000000T0
000020111111111110T11111111111112222T2T111T11111111002222222222222111111111111111T0000000000000000000
000001111111111110111111T101111222222222111101T1111T022222222T222211111111111111T00T0T000000000T00000
0000T111111111111110111T1101111122222221T0011111111112222222222222211T111111111111T00000000000T0T0000
00000111111111111111110001111111222222210000T11111112222222222222211111111111111111000000000T0000T000
T0T00T11111111111111111001T1111122222221000001111111122T222222222211111T11111111T1110T0000000T0000000
0T00000111111T11111TT100011111111T120000000000111111122222222222221T111111111111111110000T00000000000
0TT000111111111111111T0001011111111000T00000011T1111122222220021111111111111111T111100000000000000T00
00000000111111T111111000T0011111111110000000000T111111112T00011111111111111T111111111000000TT00000000
T000T00TT111111111111110001111111111120000000000111111T1T10000100111T111111T111111TT000000000TT00T000
0000000111T1111111111110011T11111122222220000001111111T11100000T011111111111111T111000000000000000000
T0000000111111111111T11100T1111T1122222220000001111111T1111000000001111111111111T1110T00000000T000000
T00000011111111111111T11T11111111122T2222000000T1111111111111100T011111111111110001110T00000000000000
000000011T111111111111101T11111T12222T2222000T01111111T111111110T00T111111111111100000TT000T000000000
0000000011111111111111001111111111222222T00000011111111111T111100000111111111111100T00000000000000000
00T000001111111111111T001011111T1122T22220000000111111T11111T11100001010111111111110000000000000000T0
0T00000011111111111111001T11T111112222222000000011100111111111111000010T111111T011100000000000000T000
000000000111111111111T111111111111111200000000T011011111111111100000000011111101010000000000000000000
00000000011111111111T1001111T11111T1000000T0000010002111T101111000000000011111100000000000T00T0T00000
000000000T111111111T000011111111T110000T0000T000022222221111111T00T000000T1111T0000000000002000000000
T000000TT1111111111T100111111111111T1000000000T002T222221T1110100000T0001111T000000T00002222222000000
000000000011T11101T010011111111111111T0T00000T000222222T11111100000T11111111000T000000002222222000000
0000T00000011T1100111T0T011111T111111100000000002222222221T11000000TT111TT111T000000000022222220T0000
00000000TT00111T001T000T01T11111111T11100000T2222222TTTT1111100000001111111110000000000222222222000T0
00000000000000T1111000000T1111111111111000000222222222221T101000000011111111100000000000222T222000000
T000000000000111T1T000TT11111111111111010T0002222222222210111000000001111T1TT110000011102222222000000
000000000TT0001T0T1100001T111T0011111110000022222222201100100000T00000011110TT1100011T112222222001100
T00000T000000001100000T0T111110010111111100002T22222000T000000000000T011T1111110001T11111102000011111
00000T000000000100000000110111100011111111T002222222000000T000T00000001011111111010111111000T00001111
T00000000000T000T000T000011111000011111T1110022222220000T000000T0T0T000001T10111001T11111000000001111
